{
    "levelname": "MainLevel",
    "levelWidth": 50,
    "levelHeight": 50,
    "conduitPosition": [
        23,
        30.5
    ],
    "spawnLocations": [
        [
            46,
            2
        ],
        [
            46,
            46
        ],
        [
            2,
            44
        ],
        [
            8,
            2
        ],
        [
            47,
            28
        ]
    ],
    "visualData": [89, 90, 90, 90, 91, 26, 89, 90, 90, 90, 90, 90, 90, 90, 90, 90, 90, 90, 90, 90, 90, 90, 91, 26, 89, 90, 90, 90, 90, 90, 90, 90, 90, 90, 90, 90, 90, 90, 90, 90, 90, 90, 90, 90, 90, 90, 90, 90, 90, 91,
            105, 21, 38, 7, 25, 26, 27, 1, 1, 1, 1, 1, 1, 1, 1, 1, 1, 1, 1, 20, 1, 1, 25, 26, 27, 1, 1, 1, 1, 1, 1, 1, 1, 1, 1, 1, 1, 1, 52, 1, 1, 1, 1, 1, 1, 1, 1, 1, 1, 107,
            105, 5, 22, 54, 25, 26, 27, 1, 50, 1, 1, 1, 52, 33, 17, 1, 1, 37, 1, 1, 5, 1, 25, 26, 27, 1, 1, 1, 1, 1, 1, 1, 2, 1, 1, 1, 37, 1, 1, 1, 1, 52, 1, 1, 1, 1, 1, 24, 17, 107,
            105, 6, 56, 6, 25, 26, 27, 36, 2, 1, 1, 1, 1, 1, 1, 1, 37, 1, 1, 1, 1, 35, 25, 26, 27, 1, 1, 1, 1, 7, 1, 33, 1, 1, 1, 51, 1, 1, 2, 1, 21, 1, 1, 1, 1, 1, 1, 19, 1, 107,
            105, 1, 1, 1, 25, 26, 121, 10, 10, 11, 1, 1, 1, 9, 10, 10, 10, 10, 10, 10, 10, 10, 123, 26, 27, 1, 1, 1, 1, 1, 1, 1, 1, 1, 1, 1, 1, 1, 1, 1, 1, 1, 1, 1, 9, 10, 10, 10, 10, 123,
            105, 1, 1, 1, 25, 26, 26, 26, 26, 27, 1, 1, 1, 25, 26, 26, 26, 26, 26, 26, 26, 26, 26, 26, 27, 1, 1, 12, 1, 1, 1, 12, 1, 1, 1, 1, 1, 14, 59, 1, 57, 16, 1, 1, 41, 42, 42, 42, 42, 91,
            105, 1, 1, 49, 41, 42, 42, 42, 42, 43, 1, 1, 1, 41, 42, 42, 42, 42, 42, 91, 26, 89, 42, 42, 43, 1, 1, 28, 1, 1, 1, 28, 1, 1, 1, 1, 1, 28, 1, 1, 1, 28, 1, 34, 1, 1, 1, 1, 1, 107,
            105, 1, 49, 1, 4, 1, 1, 1, 1, 1, 104, 69, 1, 1, 1, 1, 1, 1, 1, 25, 26, 27, 1, 1, 1, 1, 1, 28, 1, 7, 1, 28, 1, 1, 3, 1, 37, 28, 1, 1, 1, 28, 1, 1, 1, 1, 51, 1, 1, 107,
            105, 51, 1, 1, 1, 1, 1, 17, 1, 1, 102, 101, 1, 1, 1, 4, 1, 1, 1, 25, 26, 27, 21, 1, 1, 1, 1, 28, 1, 1, 1, 28, 1, 1, 1, 1, 1, 28, 1, 1, 39, 28, 1, 1, 1, 37, 1, 1, 1, 107,
            105, 1, 1, 1, 1, 1, 18, 1, 1, 1, 1, 1, 1, 1, 1, 1, 1, 51, 1, 25, 26, 27, 1, 1, 1, 40, 1, 46, 58, 58, 58, 48, 1, 39, 1, 1, 1, 46, 58, 58, 58, 48, 1, 1, 1, 1, 19, 1, 1, 107,
            121, 10, 10, 10, 10, 10, 10, 10, 10, 11, 1, 69, 1, 9, 10, 11, 1, 1, 1, 25, 26, 27, 1, 1, 1, 1, 1, 1, 1, 1, 38, 1, 36, 1, 1, 1, 1, 1, 1, 1, 1, 1, 17, 1, 1, 1, 1, 1, 34, 107,
            26, 26, 26, 26, 26, 26, 26, 26, 26, 27, 1, 85, 101, 25, 26, 27, 1, 1, 1, 25, 26, 27, 1, 1, 1, 56, 1, 1, 1, 1, 1, 20, 1, 1, 1, 97, 1, 3, 1, 1, 6, 1, 1, 1, 49, 1, 1, 22, 1, 107,
            89, 42, 42, 42, 42, 42, 42, 42, 42, 43, 1, 1, 1, 25, 26, 27, 1, 1, 1, 41, 42, 43, 1, 1, 1, 36, 1, 14, 58, 58, 58, 16, 1, 1, 1, 1, 1, 1, 1, 1, 1, 1, 1, 1, 1, 1, 1, 1, 1, 107,
            105, 1, 7, 1, 1, 1, 1, 20, 1, 1, 1, 1, 1, 25, 26, 27, 1, 1, 38, 3, 1, 1, 1, 1, 1, 1, 1, 28, 65, 85, 103, 44, 1, 1, 1, 1, 9, 10, 10, 11, 1, 1, 1, 1, 9, 11, 1, 4, 1, 107,
            105, 53, 37, 1, 18, 1, 1, 23, 1, 1, 1, 1, 1, 25, 26, 27, 4, 1, 1, 1, 1, 1, 1, 2, 1, 1, 1, 28, 82, 36, 116, 1, 1, 50, 114, 1, 25, 26, 26, 27, 1, 1, 1, 1, 25, 27, 1, 1, 1, 107,
            105, 1, 1, 1, 53, 1, 1, 1, 1, 1, 83, 84, 1, 25, 26, 27, 1, 1, 1, 1, 1, 1, 39, 1, 1, 1, 1, 28, 114, 98, 113, 12, 1, 1, 1, 1, 25, 26, 26, 27, 1, 1, 50, 6, 25, 27, 1, 1, 1, 107,
            121, 10, 10, 11, 1, 1, 1, 9, 10, 11, 1, 1, 1, 25, 26, 121, 10, 10, 10, 10, 10, 11, 1, 1, 1, 24, 1, 46, 58, 58, 58, 48, 1, 1, 1, 1, 25, 26, 26, 27, 1, 50, 1, 1, 25, 27, 1, 1, 1, 107,
            26, 26, 26, 27, 1, 20, 1, 25, 26, 27, 1, 1, 1, 25, 26, 26, 26, 26, 26, 26, 26, 27, 1, 1, 2, 1, 1, 1, 1, 1, 1, 1, 1, 98, 1, 1, 41, 42, 42, 43, 1, 1, 1, 1, 25, 27, 1, 8, 1, 107,
            89, 42, 42, 43, 1, 1, 1, 25, 26, 27, 1, 104, 1, 41, 42, 42, 42, 42, 42, 42, 42, 43, 1, 1, 1, 1, 1, 1, 1, 35, 37, 1, 1, 1, 1, 1, 1, 1, 1, 1, 1, 1, 1, 1, 25, 27, 3, 1, 1, 107,
            105, 1, 1, 1, 1, 18, 1, 25, 26, 27, 1, 66, 1, 1, 1, 38, 1, 1, 1, 1, 1, 1, 1, 1, 49, 1, 1, 1, 1, 1, 1, 98, 1, 1, 1, 1, 1, 1, 1, 102, 118, 103, 1, 1, 25, 27, 19, 1, 1, 107,
            105, 17, 1, 39, 4, 1, 1, 25, 26, 27, 1, 1, 1, 1, 51, 1, 1, 52, 35, 1, 49, 37, 1, 1, 1, 1, 1, 114, 1, 1, 1, 1, 1, 1, 1, 1, 66, 1, 1, 1, 85, 119, 1, 1, 25, 27, 1, 1, 20, 107,
            105, 1, 1, 1, 1, 1, 1, 41, 42, 43, 1, 1, 1, 1, 1, 1, 1, 1, 1, 1, 4, 1, 3, 1, 1, 114, 1, 1, 1, 1, 1, 1, 1, 1, 1, 1, 87, 56, 1, 1, 1, 1, 1, 1, 25, 27, 1, 1, 1, 107,
            121, 10, 10, 11, 1, 1, 1, 23, 1, 1, 1, 1, 1, 1, 9, 10, 10, 10, 10, 10, 10, 10, 11, 1, 113, 1, 9, 10, 10, 10, 10, 10, 10, 10, 11, 1, 1, 52, 1, 1, 1, 1, 1, 1, 25, 27, 1, 1, 1, 107,
            26, 26, 26, 27, 1, 1, 1, 1, 1, 1, 1, 114, 1, 1, 25, 89, 42, 42, 42, 42, 42, 42, 43, 1, 1, 1, 41, 42, 42, 42, 42, 42, 42, 91, 27, 1, 1, 1, 24, 1, 1, 19, 1, 1, 25, 27, 1, 1, 40, 107,
            89, 42, 42, 43, 1, 1, 1, 1, 1, 1, 104, 1, 1, 39, 25, 27, 1, 1, 55, 1, 1, 50, 1, 1, 1, 1, 1, 1, 5, 1, 1, 1, 1, 25, 27, 1, 1, 1, 1, 1, 98, 100, 1, 1, 25, 27, 1, 1, 1, 107,
            105, 1, 1, 1, 50, 1, 1, 1, 97, 101, 114, 84, 1, 1, 25, 27, 1, 40, 5, 1, 1, 1, 39, 1, 104, 1, 1, 104, 1, 1, 19, 54, 1, 25, 27, 1, 1, 1, 1, 18, 102, 1, 1, 1, 25, 27, 1, 33, 1, 107,
            105, 1, 17, 56, 1, 1, 1, 1, 1, 1, 102, 1, 1, 1, 41, 43, 1, 3, 1, 81, 1, 1, 50, 1, 1, 1, 1, 88, 1, 1, 1, 1, 1, 25, 27, 1, 1, 1, 1, 1, 1, 1, 1, 1, 25, 27, 1, 1, 1, 107,
            105, 1, 1, 1, 1, 1, 9, 11, 1, 1, 23, 1, 118, 1, 1, 1, 1, 1, 1, 1, 1, 1, 1, 104, 118, 1, 1, 1, 22, 1, 1, 1, 1, 25, 27, 1, 33, 81, 1, 1, 1, 1, 49, 1, 25, 27, 50, 1, 1, 107,
            105, 1, 49, 33, 56, 1, 25, 27, 1, 1, 1, 1, 97, 1, 1, 1, 1, 1, 104, 1, 1, 1, 1, 102, 81, 1, 1, 1, 1, 1, 82, 1, 1, 25, 27, 1, 1, 1, 1, 1, 1, 39, 1, 1, 25, 27, 56, 1, 1, 107,
            105, 1, 1, 1, 1, 1, 25, 27, 1, 1, 1, 1, 1, 1, 3, 1, 23, 1, 82, 1, 1, 14, 59, 1, 1, 1, 57, 16, 1, 1, 1, 1, 1, 41, 43, 1, 1, 1, 1, 1, 1, 1, 1, 1, 25, 27, 1, 1, 1, 107,
            105, 1, 9, 10, 10, 10, 123, 121, 10, 10, 11, 1, 1, 1, 1, 1, 1, 1, 101, 1, 1, 44, 1, 1, 1, 1, 1, 44, 1, 1, 1, 39, 1, 1, 1, 1, 1, 18, 1, 1, 1, 1, 1, 1, 25, 27, 1, 36, 1, 107,
            105, 1, 41, 42, 42, 42, 42, 42, 42, 42, 43, 1, 102, 81, 1, 1, 35, 1, 35, 1, 1, 1, 1, 1, 1, 1, 1, 1, 1, 1, 1, 1, 1, 1, 1, 1, 1, 1, 104, 1, 1, 19, 1, 1, 25, 27, 1, 1, 1, 107,
            105, 1, 1, 1, 1, 1, 1, 1, 1, 1, 1, 1, 1, 1, 1, 1, 1, 1, 24, 22, 1, 12, 1, 1, 49, 1, 1, 12, 1, 104, 1, 1, 1, 1, 1, 1, 34, 1, 113, 1, 1, 1, 1, 1, 25, 27, 1, 1, 1, 107,
            105, 1, 1, 1, 7, 50, 50, 17, 1, 1, 1, 1, 51, 1, 1, 1, 66, 1, 1, 49, 1, 46, 59, 1, 1, 1, 57, 48, 1, 83, 118, 1, 1, 9, 11, 1, 1, 1, 1, 1, 1, 1, 1, 1, 25, 27, 1, 1, 1, 107,
            105, 1, 1, 12, 1, 1, 1, 1, 55, 1, 114, 1, 1, 1, 1, 1, 1, 1, 1, 1, 1, 1, 1, 1, 52, 1, 1, 1, 1, 1, 101, 1, 40, 25, 27, 21, 1, 1, 1, 1, 18, 1, 1, 1, 25, 27, 1, 8, 1, 107,
            105, 1, 14, 47, 59, 1, 1, 1, 1, 1, 102, 1, 1, 1, 1, 1, 1, 33, 102, 98, 1, 8, 1, 1, 38, 1, 1, 104, 103, 1, 1, 1, 1, 25, 27, 1, 1, 1, 1, 1, 1, 1, 1, 1, 25, 27, 1, 1, 20, 107,
            105, 1, 44, 1, 1, 1, 1, 1, 49, 1, 1, 1, 51, 1, 9, 11, 1, 1, 1, 1, 1, 1, 104, 1, 1, 1, 1, 66, 86, 1, 1, 81, 1, 25, 27, 1, 1, 1, 17, 1, 1, 1, 1, 1, 25, 27, 1, 1, 19, 107,
            105, 1, 1, 37, 1, 1, 1, 1, 1, 1, 1, 1, 8, 1, 25, 27, 1, 22, 1, 1, 1, 1, 65, 118, 1, 1, 1, 1, 1, 1, 1, 101, 1, 25, 27, 1, 19, 1, 1, 1, 1, 82, 1, 1, 25, 27, 17, 2, 1, 107,
            105, 1, 40, 1, 1, 12, 1, 1, 1, 1, 117, 1, 1, 1, 25, 27, 1, 1, 49, 5, 1, 1, 1, 1, 1, 1, 54, 1, 1, 1, 1, 1, 8, 25, 27, 1, 1, 101, 1, 1, 1, 101, 1, 19, 25, 27, 1, 1, 1, 107,
            105, 1, 1, 1, 51, 46, 16, 1, 12, 1, 102, 1, 1, 1, 25, 121, 10, 11, 1, 1, 9, 10, 10, 10, 10, 10, 10, 10, 11, 1, 1, 9, 10, 123, 27, 1, 1, 1, 1, 1, 1, 1, 1, 1, 25, 27, 1, 24, 1, 107,
            105, 1, 12, 1, 1, 1, 46, 15, 48, 1, 1, 19, 1, 1, 41, 42, 42, 43, 1, 1, 41, 42, 42, 42, 42, 42, 42, 42, 43, 117, 1, 41, 42, 42, 43, 1, 1, 1, 52, 1, 1, 34, 39, 1, 41, 43, 1, 33, 1, 107,
            121, 109, 43, 1, 3, 1, 1, 44, 1, 1, 1, 1, 1, 50, 1, 1, 1, 1, 51, 1, 1, 1, 1, 1, 1, 1, 54, 1, 1, 1, 1, 1, 18, 3, 1, 1, 1, 1, 1, 1, 1, 1, 1, 1, 1, 36, 1, 1, 36, 107,
            89, 43, 1, 4, 1, 39, 1, 1, 1, 12, 1, 1, 1, 102, 116, 1, 1, 1, 3, 1, 1, 1, 1, 118, 1, 1, 1, 1, 1, 1, 1, 1, 1, 1, 1, 37, 49, 1, 1, 104, 103, 1, 1, 19, 1, 38, 2, 1, 1, 107,
            105, 1, 1, 1, 1, 1, 1, 1, 57, 79, 59, 1, 1, 1, 1, 1, 1, 1, 1, 1, 2, 1, 35, 85, 1, 1, 1, 1, 1, 1, 113, 1, 1, 1, 1, 1, 1, 1, 1, 82, 118, 1, 1, 1, 9, 10, 10, 10, 10, 123,
            105, 1, 51, 1, 57, 16, 1, 1, 1, 44, 1, 1, 57, 16, 1, 1, 102, 113, 1, 1, 1, 1, 1, 1, 36, 104, 118, 1, 1, 1, 1, 1, 17, 1, 1, 1, 1, 1, 1, 1, 1, 1, 1, 1, 41, 42, 42, 42, 42, 91,
            105, 1, 1, 54, 1, 46, 16, 1, 1, 1, 1, 50, 1, 30, 59, 1, 1, 1, 1, 1, 1, 1, 37, 1, 49, 1, 1, 1, 1, 1, 1, 1, 1, 1, 1, 1, 1, 1, 1, 1, 1, 1, 1, 1, 1, 1, 1, 55, 1, 107,
            105, 1, 12, 1, 1, 1, 44, 1, 19, 1, 7, 1, 57, 32, 1, 1, 2, 3, 1, 1, 1, 1, 1, 1, 1, 1, 1, 1, 1, 1, 1, 98, 100, 1, 1, 1, 1, 82, 101, 1, 1, 1, 4, 1, 1, 1, 1, 1, 1, 107,
            105, 1, 46, 59, 50, 1, 1, 33, 55, 1, 17, 1, 1, 30, 59, 1, 1, 1, 52, 37, 1, 1, 36, 1, 1, 1, 1, 18, 5, 1, 1, 4, 1, 1, 18, 1, 1, 1, 1, 20, 1, 1, 8, 1, 1, 1, 39, 1, 50, 107,
            105, 1, 1, 1, 1, 1, 18, 1, 1, 1, 1, 1, 57, 48, 1, 1, 1, 1, 1, 1, 1, 1, 1, 1, 1, 1, 1, 1, 1, 1, 1, 17, 1, 1, 1, 1, 1, 1, 1, 1, 1, 1, 1, 1, 1, 34, 1, 1, 1, 107,
            121, 122, 122, 122, 122, 122, 122, 122, 122, 122, 122, 122, 122, 122, 122, 122, 122, 122, 122, 122, 122, 122, 122, 122, 122, 122, 122, 122, 122, 122, 122, 122, 122, 122, 122, 122, 122, 122, 122, 122, 122, 122, 122, 122, 122, 122, 122, 122, 122, 123]
        ,
    "colliderData": [256, 256, 256, 256, 256, 256, 256, 256, 256, 256, 256, 256, 256, 256, 256, 256, 256, 256, 256, 256, 256, 256, 256, 256, 256, 256, 256, 256, 256, 256, 256, 256, 256, 256, 256, 256, 256, 256, 256, 256, 256, 256, 256, 256, 256, 256, 256, 256, 256, 256,
            256, 0, 0, 0, 256, 256, 256, 0, 0, 0, 0, 0, 0, 0, 0, 0, 0, 0, 0, 0, 0, 0, 256, 256, 256, 0, 0, 0, 0, 0, 0, 0, 0, 0, 0, 0, 0, 0, 0, 0, 0, 0, 0, 0, 0, 0, 0, 0, 0, 256,
            256, 0, 0, 0, 256, 256, 256, 0, 0, 0, 0, 0, 0, 0, 0, 0, 0, 0, 0, 0, 0, 0, 256, 256, 256, 0, 0, 0, 0, 0, 0, 0, 0, 0, 0, 0, 0, 0, 0, 0, 0, 0, 0, 0, 0, 0, 0, 0, 0, 256,
            256, 0, 0, 0, 256, 256, 256, 0, 0, 0, 0, 0, 0, 0, 0, 0, 0, 0, 0, 0, 0, 0, 256, 256, 256, 0, 0, 0, 0, 0, 0, 0, 0, 0, 0, 0, 0, 0, 0, 0, 0, 0, 0, 0, 0, 0, 0, 0, 0, 256,
            256, 0, 0, 0, 256, 256, 256, 256, 256, 256, 0, 0, 0, 256, 256, 256, 256, 256, 256, 256, 256, 256, 256, 256, 256, 0, 0, 0, 0, 0, 0, 0, 0, 0, 0, 0, 0, 0, 0, 0, 0, 0, 0, 0, 256, 256, 256, 256, 256, 256,
            256, 0, 0, 0, 256, 256, 256, 256, 256, 256, 0, 0, 0, 256, 256, 256, 256, 256, 256, 256, 256, 256, 256, 256, 256, 0, 0, 256, 0, 0, 0, 256, 0, 0, 0, 0, 0, 256, 256, 0, 256, 256, 0, 0, 256, 256, 256, 256, 256, 256,
            256, 0, 0, 0, 256, 256, 256, 256, 256, 256, 0, 0, 0, 256, 256, 256, 256, 256, 256, 256, 256, 256, 256, 256, 256, 0, 0, 256, 0, 0, 0, 256, 0, 0, 0, 0, 0, 256, 0, 0, 0, 256, 0, 0, 0, 0, 0, 0, 0, 256,
            256, 0, 0, 0, 0, 0, 0, 0, 0, 0, 0, 0, 0, 0, 0, 0, 0, 0, 0, 256, 256, 256, 0, 0, 0, 0, 0, 256, 0, 0, 0, 256, 0, 0, 0, 0, 0, 256, 0, 0, 0, 256, 0, 0, 0, 0, 0, 0, 0, 256,
            256, 0, 0, 0, 0, 0, 0, 0, 0, 0, 0, 0, 0, 0, 0, 0, 0, 0, 0, 256, 256, 256, 0, 0, 0, 0, 0, 256, 0, 0, 0, 256, 0, 0, 0, 0, 0, 256, 0, 0, 0, 256, 0, 0, 0, 0, 0, 0, 0, 256,
            256, 0, 0, 0, 0, 0, 0, 0, 0, 0, 0, 0, 0, 0, 0, 0, 0, 0, 0, 256, 256, 256, 0, 0, 0, 0, 0, 256, 256, 256, 256, 256, 0, 0, 0, 0, 0, 256, 256, 256, 256, 256, 0, 0, 0, 0, 0, 0, 0, 256,
            256, 256, 256, 256, 256, 256, 256, 256, 256, 256, 0, 0, 0, 256, 256, 256, 0, 0, 0, 256, 256, 256, 0, 0, 0, 0, 0, 0, 0, 0, 0, 0, 0, 0, 0, 0, 0, 0, 0, 0, 0, 0, 0, 0, 0, 0, 0, 0, 0, 256,
            256, 256, 256, 256, 256, 256, 256, 256, 256, 256, 0, 0, 0, 256, 256, 256, 0, 0, 0, 256, 256, 256, 0, 0, 0, 0, 0, 0, 0, 0, 0, 0, 0, 0, 0, 0, 0, 0, 0, 0, 0, 0, 0, 0, 0, 0, 0, 0, 0, 256,
            256, 256, 256, 256, 256, 256, 256, 256, 256, 256, 0, 0, 0, 256, 256, 256, 0, 0, 0, 256, 256, 256, 0, 0, 0, 0, 0, 256, 256, 256, 256, 256, 0, 0, 0, 0, 0, 0, 0, 0, 0, 0, 0, 0, 0, 0, 0, 0, 0, 256,
            256, 0, 0, 0, 0, 0, 0, 0, 0, 0, 0, 0, 0, 256, 256, 256, 0, 0, 0, 0, 0, 0, 0, 0, 0, 0, 0, 256, 0, 0, 0, 256, 0, 0, 0, 0, 256, 256, 256, 256, 0, 0, 0, 0, 256, 256, 0, 0, 0, 256,
            256, 0, 0, 0, 0, 0, 0, 0, 0, 0, 0, 0, 0, 256, 256, 256, 0, 0, 0, 0, 0, 0, 0, 0, 0, 0, 0, 256, 0, 0, 0, 0, 0, 0, 0, 0, 256, 256, 256, 256, 0, 0, 0, 0, 256, 256, 0, 0, 0, 256,
            256, 0, 0, 0, 0, 0, 0, 0, 0, 0, 0, 0, 0, 256, 256, 256, 0, 0, 0, 0, 0, 0, 0, 0, 0, 0, 0, 256, 0, 0, 0, 256, 0, 0, 0, 0, 256, 256, 256, 256, 0, 0, 0, 0, 256, 256, 0, 0, 0, 256,
            256, 256, 256, 256, 0, 0, 0, 256, 256, 256, 0, 0, 0, 256, 256, 256, 256, 256, 256, 256, 256, 256, 0, 0, 0, 0, 0, 256, 256, 256, 256, 256, 0, 0, 0, 0, 256, 256, 256, 256, 0, 0, 0, 0, 256, 256, 0, 0, 0, 256,
            256, 256, 256, 256, 0, 0, 0, 256, 256, 256, 0, 0, 0, 256, 256, 256, 256, 256, 256, 256, 256, 256, 0, 0, 0, 0, 0, 0, 0, 0, 0, 0, 0, 0, 0, 0, 256, 256, 256, 256, 0, 0, 0, 0, 256, 256, 0, 0, 0, 256,
            256, 256, 256, 256, 0, 0, 0, 256, 256, 256, 0, 0, 0, 256, 256, 256, 256, 256, 256, 256, 256, 256, 0, 0, 0, 0, 0, 0, 0, 0, 0, 0, 0, 0, 0, 0, 0, 0, 0, 0, 0, 0, 0, 0, 256, 256, 0, 0, 0, 256,
            256, 0, 0, 0, 0, 0, 0, 256, 256, 256, 0, 0, 0, 0, 0, 0, 0, 0, 0, 0, 0, 0, 0, 0, 0, 0, 0, 0, 0, 0, 0, 0, 0, 0, 0, 0, 0, 0, 0, 0, 0, 0, 0, 0, 256, 256, 0, 0, 0, 256,
            256, 0, 0, 0, 0, 0, 0, 256, 256, 256, 0, 0, 0, 0, 0, 0, 0, 0, 0, 0, 0, 0, 0, 0, 0, 0, 0, 0, 0, 0, 0, 0, 0, 0, 0, 0, 0, 0, 0, 0, 0, 0, 0, 0, 256, 256, 0, 0, 0, 256,
            256, 0, 0, 0, 0, 0, 0, 256, 256, 256, 0, 0, 0, 0, 0, 0, 0, 0, 0, 0, 0, 0, 0, 0, 0, 0, 0, 0, 0, 0, 0, 0, 0, 0, 0, 0, 0, 0, 0, 0, 0, 0, 0, 0, 256, 256, 0, 0, 0, 256,
            256, 256, 256, 256, 0, 0, 0, 0, 0, 0, 0, 0, 0, 0, 256, 256, 256, 256, 256, 256, 256, 256, 256, 0, 0, 0, 256, 256, 256, 256, 256, 256, 256, 256, 256, 0, 0, 0, 0, 0, 0, 0, 0, 0, 256, 256, 0, 0, 0, 256,
            256, 256, 256, 256, 0, 0, 0, 0, 0, 0, 0, 0, 0, 0, 256, 256, 256, 256, 256, 256, 256, 256, 256, 0, 0, 0, 256, 256, 256, 256, 256, 256, 256, 256, 256, 0, 0, 0, 0, 0, 0, 0, 0, 0, 256, 256, 0, 0, 0, 256,
            256, 256, 256, 256, 0, 0, 0, 0, 0, 0, 0, 0, 0, 0, 256, 256, 0, 0, 0, 0, 0, 0, 0, 0, 0, 0, 0, 0, 0, 0, 0, 0, 0, 256, 256, 0, 0, 0, 0, 0, 0, 0, 0, 0, 256, 256, 0, 0, 0, 256,
            256, 0, 0, 0, 0, 0, 0, 0, 0, 0, 0, 0, 0, 0, 256, 256, 0, 0, 0, 0, 0, 0, 0, 0, 0, 0, 0, 0, 0, 0, 0, 0, 0, 256, 256, 0, 0, 0, 0, 0, 0, 0, 0, 0, 256, 256, 0, 0, 0, 256,
            256, 0, 0, 0, 0, 0, 0, 0, 0, 0, 0, 0, 0, 0, 256, 256, 0, 0, 0, 0, 0, 0, 0, 0, 0, 0, 0, 0, 0, 0, 0, 0, 0, 256, 256, 0, 0, 0, 0, 0, 0, 0, 0, 0, 256, 256, 0, 0, 0, 256,
            256, 0, 0, 174, 174, 174, 256, 256, 174, 174, 174, 174, 174, 174, 0, 0, 0, 0, 0, 0, 0, 0, 0, 0, 0, 0, 0, 0, 0, 0, 0, 0, 0, 256, 256, 0, 0, 0, 0, 0, 0, 0, 0, 0, 256, 256, 0, 0, 0, 256,
            256, 0, 174, 174, 174, 174, 256, 256, 174, 174, 174, 174, 174, 174, 174, 0, 0, 0, 0, 0, 0, 0, 0, 0, 0, 0, 0, 0, 0, 0, 0, 0, 0, 256, 256, 0, 0, 0, 0, 0, 0, 0, 0, 0, 256, 256, 0, 0, 0, 256,
            256, 0, 174, 174, 174, 174, 256, 256, 174, 174, 174, 174, 174, 174, 174, 0, 0, 0, 0, 0, 0, 256, 256, 0, 0, 0, 256, 256, 0, 0, 0, 0, 0, 256, 256, 0, 0, 0, 0, 0, 0, 0, 0, 0, 256, 256, 0, 0, 0, 256,
            256, 0, 256, 256, 256, 256, 256, 256, 256, 256, 256, 174, 174, 174, 0, 0, 0, 0, 0, 0, 0, 256, 0, 0, 0, 0, 0, 256, 0, 0, 0, 0, 0, 0, 0, 0, 0, 0, 0, 0, 0, 0, 0, 0, 256, 256, 0, 0, 0, 256,
            256, 0, 256, 256, 256, 256, 256, 256, 256, 256, 256, 0, 0, 0, 0, 0, 0, 0, 0, 0, 0, 0, 0, 0, 0, 0, 0, 0, 0, 0, 0, 0, 0, 0, 0, 0, 0, 0, 0, 0, 0, 0, 0, 0, 256, 256, 0, 0, 0, 256,
            256, 174, 174, 174, 174, 0, 0, 0, 0, 0, 0, 0, 0, 0, 0, 0, 0, 0, 0, 0, 0, 256, 0, 0, 0, 0, 0, 256, 0, 0, 0, 0, 0, 0, 0, 0, 0, 0, 0, 0, 0, 0, 0, 0, 256, 256, 0, 0, 0, 256,
            256, 0, 0, 174, 174, 0, 0, 0, 0, 0, 174, 174, 174, 174, 174, 0, 0, 0, 0, 0, 0, 256, 256, 0, 0, 0, 256, 256, 0, 0, 0, 0, 0, 256, 256, 0, 0, 0, 0, 0, 0, 0, 0, 0, 256, 256, 0, 0, 0, 256,
            256, 0, 0, 256, 174, 0, 0, 174, 174, 174, 174, 174, 174, 174, 174, 174, 174, 0, 0, 0, 0, 0, 0, 0, 0, 0, 0, 0, 0, 0, 0, 0, 0, 256, 256, 0, 0, 0, 0, 0, 0, 0, 0, 0, 256, 256, 0, 0, 0, 256,
            256, 0, 256, 256, 256, 174, 174, 174, 174, 174, 174, 174, 174, 174, 174, 0, 0, 0, 0, 0, 0, 0, 0, 0, 0, 0, 0, 0, 0, 0, 0, 0, 0, 256, 256, 0, 0, 0, 0, 0, 0, 0, 0, 0, 256, 256, 0, 0, 0, 256,
            256, 0, 256, 174, 174, 174, 174, 174, 174, 174, 174, 174, 174, 0, 256, 256, 0, 0, 0, 0, 0, 0, 0, 0, 0, 0, 0, 0, 0, 0, 0, 0, 0, 256, 256, 0, 0, 0, 0, 0, 0, 0, 0, 0, 256, 256, 0, 0, 0, 256,
            256, 0, 0, 174, 174, 174, 174, 174, 174, 174, 174, 0, 0, 0, 256, 256, 0, 0, 0, 0, 0, 0, 0, 0, 0, 0, 0, 0, 0, 0, 0, 0, 0, 256, 256, 0, 0, 0, 0, 0, 0, 0, 0, 0, 256, 256, 0, 0, 0, 256,
            256, 0, 0, 0, 174, 256, 174, 0, 0, 0, 0, 0, 0, 0, 256, 256, 0, 0, 0, 0, 0, 0, 0, 0, 0, 0, 0, 0, 0, 0, 0, 0, 0, 256, 256, 0, 0, 0, 0, 0, 0, 0, 0, 0, 256, 256, 0, 0, 0, 256,
            256, 0, 0, 0, 0, 256, 256, 0, 256, 0, 0, 0, 0, 0, 256, 256, 256, 256, 0, 0, 256, 256, 256, 256, 256, 256, 256, 256, 256, 0, 0, 256, 256, 256, 256, 0, 0, 0, 0, 0, 0, 0, 0, 0, 256, 256, 0, 0, 0, 256,
            256, 0, 256, 0, 0, 0, 256, 256, 256, 0, 0, 0, 0, 0, 256, 256, 256, 256, 0, 0, 256, 256, 256, 256, 256, 256, 256, 256, 256, 0, 0, 256, 256, 256, 256, 0, 0, 0, 0, 0, 0, 0, 0, 0, 256, 256, 0, 0, 0, 256,
            256, 256, 256, 0, 0, 0, 0, 256, 0, 0, 0, 0, 0, 0, 0, 0, 0, 0, 0, 0, 0, 0, 0, 0, 0, 0, 0, 0, 0, 0, 0, 0, 0, 0, 0, 0, 0, 0, 0, 0, 0, 0, 0, 0, 0, 0, 0, 0, 0, 256,
            256, 256, 0, 0, 0, 0, 0, 0, 0, 256, 0, 0, 0, 0, 0, 0, 0, 0, 0, 0, 0, 0, 0, 0, 0, 0, 0, 0, 0, 0, 0, 0, 0, 0, 0, 0, 0, 0, 0, 0, 0, 0, 0, 0, 0, 0, 0, 0, 0, 256,
            256, 0, 0, 0, 0, 0, 0, 0, 256, 256, 256, 0, 0, 0, 0, 0, 0, 0, 0, 0, 0, 0, 0, 0, 0, 0, 0, 0, 0, 0, 0, 0, 0, 0, 0, 0, 0, 0, 0, 0, 0, 0, 0, 0, 256, 256, 256, 256, 256, 256,
            256, 0, 0, 0, 256, 256, 0, 0, 0, 256, 0, 0, 256, 256, 0, 0, 0, 0, 0, 0, 0, 0, 0, 0, 0, 0, 0, 0, 0, 0, 0, 0, 0, 0, 0, 0, 0, 0, 0, 0, 0, 0, 0, 0, 256, 256, 256, 256, 256, 256,
            256, 0, 0, 0, 0, 256, 256, 0, 0, 0, 0, 0, 0, 256, 256, 0, 0, 0, 0, 0, 0, 0, 0, 0, 0, 0, 0, 0, 0, 0, 0, 0, 0, 0, 0, 0, 0, 0, 0, 0, 0, 0, 0, 0, 0, 0, 0, 0, 0, 256,
            256, 0, 256, 0, 0, 0, 256, 0, 0, 0, 0, 0, 256, 256, 0, 0, 0, 0, 0, 0, 0, 0, 0, 0, 0, 0, 0, 0, 0, 0, 0, 0, 0, 0, 0, 0, 0, 0, 0, 0, 0, 0, 0, 0, 0, 0, 0, 0, 0, 256,
            256, 0, 256, 256, 0, 0, 0, 0, 0, 0, 0, 0, 0, 256, 256, 0, 0, 0, 0, 0, 0, 0, 0, 0, 0, 0, 0, 0, 0, 0, 0, 0, 0, 0, 0, 0, 0, 0, 0, 0, 0, 0, 0, 0, 0, 0, 0, 0, 0, 256,
            256, 0, 0, 0, 0, 0, 0, 0, 0, 0, 0, 0, 256, 256, 0, 0, 0, 0, 0, 0, 0, 0, 0, 0, 0, 0, 0, 0, 0, 0, 0, 0, 0, 0, 0, 0, 0, 0, 0, 0, 0, 0, 0, 0, 0, 0, 0, 0, 0, 256,
            256, 256, 256, 256, 256, 256, 256, 256, 256, 256, 256, 256, 256, 256, 256, 256, 256, 256, 256, 256, 256, 256, 256, 256, 256, 256, 256, 256, 256, 256, 256, 256, 256, 256, 256, 256, 256, 256, 256, 256, 256, 256, 256, 256, 256, 256, 256, 256, 256, 256]
}