25,25,25,25,25,25,25,25,25,25,25,25,25,25,25,25,25,25,25,25,25,25,25,25,25,25,25,25,25,25,25,25,25,25,25,25,25,25,25,25,25,25,25,25,25,25,25,25,25,25
25,25,25,25,25,25,25,25,25,25,25,25,25,25,25,25,25,25,25,25,25,25,25,25,25,25,25,25,25,25,25,25,25,25,25,25,25,25,25,25,25,25,25,25,25,25,25,25,25,25
25,25,25,25,25,25,25,25,25,25,25,25,25,25,25,25,25,25,25,25,25,25,25,25,25,25,25,25,25,25,25,25,25,25,25,25,25,25,25,25,25,25,25,25,25,25,25,25,25,25
25,25,25,0,0,0,19,0,0,25,25,0,0,0,0,25,25,0,0,33,50,0,0,0,0,0,0,0,0,25,25,0,0,0,0,25,25,0,0,0,0,0,0,0,0,0,0,25,25,25
25,25,25,25,25,33,0,17,0,16,0,0,0,0,0,0,0,0,0,0,0,0,0,0,0,34,0,0,0,0,0,0,0,0,0,0,25,0,0,0,0,0,16,0,0,17,0,25,25,25
25,25,25,25,25,0,0,0,0,0,17,0,0,0,0,0,0,0,0,0,0,0,0,0,0,0,0,0,0,0,0,0,0,0,0,0,18,0,0,51,0,0,17,0,0,0,0,25,25,25
25,25,25,25,25,0,0,0,0,25,25,18,0,0,0,25,25,0,0,0,0,0,0,0,17,0,0,0,0,25,25,0,0,0,0,25,25,0,0,0,35,32,0,0,0,0,0,25,25,25
25,25,25,25,25,0,0,25,25,25,25,33,0,0,0,25,25,25,25,25,25,25,25,25,25,25,25,0,8,9,10,0,0,0,0,25,25,0,0,0,18,33,0,0,0,0,0,25,25,25
25,25,25,48,0,0,0,25,25,25,25,0,33,52,0,25,25,25,25,25,25,25,25,25,25,25,25,0,40,90,26,0,0,0,0,25,25,0,0,33,0,0,35,0,0,0,0,25,25,25
25,25,25,35,0,0,0,25,25,25,25,0,0,0,0,25,25,0,0,0,0,0,0,0,0,0,0,0,0,106,26,0,0,0,0,25,25,0,0,0,0,0,0,0,0,0,0,25,25,25
25,25,25,0,0,0,35,0,0,25,25,0,0,0,32,25,25,0,0,0,0,0,0,0,0,0,0,0,0,106,26,0,19,0,0,25,25,0,35,0,0,0,0,32,0,0,0,25,25,25
25,25,25,0,0,0,0,0,0,25,25,0,0,0,0,25,25,25,25,25,25,0,0,0,0,8,121,121,121,122,26,0,0,0,0,25,25,25,25,32,0,0,0,25,25,25,25,25,25,25
25,25,25,25,25,0,0,0,0,0,0,0,0,0,0,25,25,25,25,25,25,0,0,0,0,40,41,41,41,41,42,0,0,0,0,25,25,25,25,0,0,0,32,25,25,25,25,25,25,25
25,25,25,25,25,0,0,2,0,0,25,0,33,0,0,0,0,0,0,0,0,0,0,0,0,0,0,49,0,0,0,0,0,0,50,0,0,37,0,0,0,0,0,0,0,0,0,25,25,25
25,25,25,25,25,0,0,32,3,25,25,1,51,54,0,37,18,0,0,0,0,0,0,0,0,0,0,0,0,35,0,0,0,17,0,0,0,0,0,0,0,0,34,0,0,0,0,25,25,25
25,25,25,0,0,0,0,0,0,25,25,0,0,0,0,0,0,0,0,0,35,0,0,0,0,0,18,0,0,51,0,0,0,0,0,0,0,0,0,0,0,0,19,0,0,0,0,25,25,25
25,25,25,0,0,0,0,49,0,25,25,0,0,0,0,0,0,0,0,0,0,33,0,0,0,0,0,0,0,0,0,0,0,0,0,0,50,0,0,0,0,0,0,0,0,0,0,25,25,25
25,25,25,0,0,2,0,0,0,25,25,35,0,0,0,25,25,25,25,25,0,0,0,0,0,0,25,25,25,25,25,0,0,0,0,25,25,25,25,0,0,0,0,25,25,25,25,25,25,25
25,25,25,0,0,0,25,25,25,25,25,0,23,0,0,25,25,25,25,25,7,0,0,0,0,0,25,25,25,25,25,0,0,0,0,25,25,25,25,0,17,0,0,25,25,25,25,25,25,25
25,25,25,50,0,0,25,25,25,25,25,0,0,0,0,25,25,25,25,0,0,0,23,0,0,0,0,25,25,25,25,0,0,0,0,25,25,25,25,0,0,0,51,0,0,0,0,25,25,25
25,25,25,0,0,0,3,0,0,25,25,17,35,35,0,25,25,25,25,0,0,1,0,0,36,0,36,25,25,25,25,0,0,0,0,25,25,25,25,0,25,0,0,0,0,0,0,25,25,25
25,25,25,0,0,0,0,0,0,25,25,0,32,35,0,25,25,0,0,0,0,0,0,0,0,0,21,0,0,25,25,3,0,0,16,25,25,25,25,0,25,0,0,0,51,0,35,25,25,25
25,25,25,25,25,25,0,0,0,25,25,0,0,0,0,0,0,0,18,0,21,0,0,0,0,0,0,0,0,0,48,0,0,0,0,25,25,25,25,0,0,0,25,25,32,0,0,25,25,25
25,25,25,25,25,25,0,0,0,25,25,0,0,0,0,0,0,5,0,0,33,0,25,25,0,0,0,0,0,0,0,0,0,0,19,25,25,25,25,0,34,0,0,0,50,0,0,25,25,25
25,25,25,0,0,0,0,0,0,0,0,0,0,0,0,0,0,0,0,0,0,25,25,25,25,0,0,0,0,19,0,3,0,0,0,25,25,25,25,0,0,0,0,0,0,0,0,25,25,25
25,25,25,0,0,0,0,49,0,1,0,49,0,0,0,0,16,0,0,0,0,25,25,25,25,0,0,0,4,0,0,0,17,0,0,25,25,25,25,19,0,19,25,25,0,0,0,25,25,25
25,25,25,25,25,25,25,25,25,25,25,0,0,0,0,0,36,0,0,0,35,0,25,25,0,0,0,0,0,0,0,0,0,0,0,25,25,25,25,0,0,0,25,25,0,0,51,25,25,25
25,25,25,25,25,25,25,25,25,25,25,0,0,0,0,0,4,0,0,18,0,0,0,0,0,0,0,0,0,0,0,0,0,53,0,25,25,25,25,0,0,0,25,25,0,0,50,25,25,25
25,25,25,0,0,0,0,0,0,0,35,0,0,51,0,25,25,0,51,0,0,0,0,2,0,0,0,0,0,25,25,0,0,0,0,25,25,25,25,0,0,3,0,0,0,0,0,25,25,25
25,25,25,0,0,0,34,0,0,0,0,0,0,0,0,25,25,25,25,0,0,0,0,51,50,0,0,25,25,25,25,0,19,0,0,25,25,25,25,0,0,0,0,0,0,0,0,25,25,25
25,25,25,0,0,0,0,0,0,0,0,0,0,48,0,25,25,25,25,0,0,0,0,0,0,6,0,25,25,25,25,0,0,0,0,25,25,25,25,0,0,0,0,0,0,0,0,25,25,25
25,25,25,16,0,25,25,25,25,25,25,0,0,0,0,25,25,25,25,25,0,0,0,0,0,0,25,25,25,25,25,0,0,0,0,25,25,25,25,0,0,0,0,0,0,0,0,25,25,25
25,25,25,0,0,25,25,25,25,25,25,0,0,0,0,25,25,25,25,25,0,4,0,0,0,0,25,25,25,25,25,0,0,0,0,25,25,25,25,0,0,0,50,25,25,0,0,25,25,25
25,25,25,0,0,25,25,0,0,0,0,0,0,0,0,0,0,0,0,0,0,0,33,0,0,0,0,0,0,0,0,35,0,23,0,0,35,0,17,0,0,0,0,25,25,0,0,25,25,25
25,25,25,0,0,25,25,3,0,0,0,0,0,0,0,0,0,0,34,0,0,0,51,0,0,0,0,0,0,0,0,0,0,0,0,0,0,0,0,0,0,0,0,0,0,0,0,25,25,25
25,25,25,0,0,25,25,25,25,25,25,0,0,0,25,25,25,25,25,0,0,17,0,18,0,0,0,0,0,36,0,0,0,25,25,25,25,0,0,0,0,0,0,0,0,0,0,25,25,25
25,25,25,0,0,25,25,25,25,25,25,0,0,0,25,25,25,25,25,0,0,0,25,25,25,0,0,0,0,0,0,0,0,25,25,25,25,0,0,0,0,0,0,0,0,0,0,25,25,25
25,25,25,0,0,0,0,0,0,0,0,0,0,0,25,25,25,25,25,0,0,0,25,25,25,0,0,0,0,0,0,0,0,25,25,25,25,0,0,0,0,0,0,0,0,0,0,25,25,25
25,25,25,18,0,25,25,25,25,25,25,0,0,0,25,25,25,25,25,0,0,35,25,25,25,0,0,0,25,25,25,25,0,0,0,2,0,0,0,25,25,25,25,25,0,0,0,25,25,25
25,25,25,0,0,25,25,25,25,25,25,0,0,0,25,25,25,25,25,0,0,0,25,25,25,0,0,0,25,25,25,25,0,0,0,0,0,0,0,25,25,25,25,25,19,0,0,25,25,25
25,25,25,0,0,25,25,0,0,25,25,18,34,0,25,25,25,25,25,0,0,0,0,0,0,0,0,1,25,25,25,25,0,0,0,0,0,0,0,25,25,25,25,25,0,0,0,25,25,25
25,25,25,0,0,25,25,0,0,0,0,0,0,0,0,0,0,0,0,0,0,0,0,0,0,0,0,0,25,25,25,25,0,0,0,0,0,0,0,25,25,25,25,25,0,0,0,25,25,25
25,25,25,0,35,25,25,16,0,25,25,0,1,0,0,0,0,0,0,0,50,25,25,25,25,0,0,0,34,0,0,0,0,0,0,25,25,0,0,25,25,25,25,25,0,0,0,25,25,25
25,25,25,0,0,25,25,25,25,25,25,0,0,0,0,0,25,0,0,0,49,25,25,25,25,0,0,0,0,0,0,0,0,0,0,25,25,0,0,0,19,0,0,0,0,48,0,25,25,25
25,25,25,0,0,25,25,25,25,25,25,0,0,25,25,25,25,2,0,0,0,0,0,0,0,0,49,0,0,0,0,0,0,0,0,0,0,0,0,16,0,0,0,0,0,0,0,25,25,25
25,25,25,0,0,0,50,51,17,0,0,0,0,25,25,25,25,0,32,0,0,0,19,0,0,0,18,0,0,25,0,0,19,34,0,32,0,0,0,0,51,0,0,0,0,0,0,25,25,25
25,25,25,0,18,0,51,17,0,0,0,0,0,25,25,25,25,0,0,34,0,0,0,0,0,0,0,0,32,16,0,0,0,0,0,0,0,0,0,0,0,0,0,0,0,50,0,25,25,25
25,25,25,25,25,25,25,25,25,25,25,25,25,25,25,25,25,25,25,25,25,25,25,25,25,25,25,25,25,25,25,25,25,25,25,25,25,25,25,25,25,25,25,25,25,25,25,25,25,25
25,25,25,25,25,25,25,25,25,25,25,25,25,25,25,25,25,25,25,25,25,25,25,25,25,25,25,25,25,25,25,25,25,25,25,25,25,25,25,25,25,25,25,25,25,25,25,25,25,25
25,25,25,25,25,25,25,25,25,25,25,25,25,25,25,25,25,25,25,25,25,25,25,25,25,25,25,25,25,25,25,25,25,25,25,25,25,25,25,25,25,25,25,25,25,25,25,25,25,25
